wwwwwwwwwwwwwwwwwwwwwwwww
w p    w                w
w      w          w     w
w      w          w     w
w      w          w     w
w      w          w     w
w      w          w     w
w      wwwwwww    w     w     
w        w        w     w
w        w        w     w
w                 w     w
wwwwwwwwwwwwwwwwwww     w                  
w                       w
w                       w
w    wwwwwwwwwwwwwwwwwwww                   
w                       w
w                       w
wwwwwwwwwwwwwwwwww      w
w  t                    w
wwwwwwwwwwwwwwwwwwwwwwwww