wwwwwwwwwwwwwwwwwwwwwwwww
w p    w                w
w      w          w     w
w      w          w     w
w      w          w     w
w      w  e       w     w
w      w          w     w
w  e   wwwwwww    w     w     
w        w        w     w
w        w     e  w     w
w                 w     w
wwwwwwwwwwwwwwwwwww     w                  
w                   e   w
w        e              w
w    wwwwwwwwwwwwwwwwwwww                   
w       e               w
w                  e    w
wwwwwwwwwwwwwwwwww      w
w  t                    w
wwwwwwwwwwwwwwwwwwwwwwwww